##############################################################################
#@...........................................................................#
#...........................................D................................#
#............................................................................#
#............................................................................#
#..............................#####.........................................#
#.............................##...#.........................................#
#.............................#..............................................#
#.............................#..............................................#
#.............................##...#...........................S.............#
#..............................#####.........................................#
#............................................................................#
#..................S.........................................................#
#............................................................................#
#............................................................................#
#............................................................................#
##############################################################################
